AUT	'Austria'
BEL	'Belgium'
BGR	'Bulgaria'
HRV	'Croatia'
CZE	'Czech Republic'
CYP	'Cyprus'
DNK	'Denmark'
EST	'Estonia'
FIN	'Finland'
FRA	'France'
DEU	'Germany'
GRC	'Greece'
HUN	'Hungary'
IRL	'Ireland'
ITA	'Italy'
LVA	'Latvia'
LTU	'Lituania'
LUX	'Luxembourg'
MLT	'Malta'
NLD	'Netherlands'
POL	'Poland'
PRT	'Portugal'
ROU	'Romania'
SVK	'Slovakia'
SVN	'Slovenia'
ESP	'Spain'
SWE	'Sweden'
GBR	'Great Britain'
RWO	'Developed regions Rest of the World'
RWN	'Undeveloped regions Rest of the World'
